NO includes/textures/cobblestone.xpm
SO includes/textures/cobblestone.xpm
WE includes/textures/cobblestone.xpm
EA includes/textures/cobblestone.xpm

F 255,169,25
C 100,100,0

111111111111111111111111111
10100000100E000001000000001111111
101010101011111110100000000000001
100010100010000010001111111111101
111110101111101011101         101
100000101000101000001         111
101111101011101111111
101000001010100000101
101011111010111110101
101010001010100010101
101110101010101010101
100000101010001010001
111111101011111011101
100000101000100010001
101110101110101110111
101000100000100010101
101011111111111010101
100010000000000010001
101010111011111111101
100100001000000000001
111111111111111111111

